Niveau 54 : Expert
+---+---+---+---+
|   |   | P |   |
+---+---+---+---+
|   |   |   |   |
+---+---+---+---+
| C | T | F | P |
+---+---+---+---+
|   | T | C |   |
+---+---+---+---+