Niveau 6 : Débutant
+---+---+---+---+
|   |   |   |   |
+---+---+---+---+
|   | T | F |   |
+---+---+---+---+
| K |   |   |   |
+---+---+---+---+
| C |   |   |   |
+---+---+---+---+