Niveau 31 : Avancé
+---+---+---+---+
|   |   |   | P |
+---+---+---+---+
| T | K | Q |   |
+---+---+---+---+
|   |   | P |   |
+---+---+---+---+
|   |   | T |   |
+---+---+---+---+