Niveau 3 : Débutant
+---+---+---+---+
|   |   |   | T |
+---+---+---+---+
| C |   | P |   |
+---+---+---+---+
|   |   |   |   |
+---+---+---+---+
| C |   |   | P |
+---+---+---+---+