Niveau 20 : Intermédiaire
+---+---+---+---+
|   | T | P |   |
+---+---+---+---+
| T | F |   |   |
+---+---+---+---+
|   | P |   |   |
+---+---+---+---+
|   |   |   |   |
+---+---+---+---+