Niveau 52 : Expert
+---+---+---+---+
|   |   |   | T |
+---+---+---+---+
| F | K | C |   |
+---+---+---+---+
|   | T |   |   |
+---+---+---+---+
| P | F | P |   |
+---+---+---+---+