Niveau 37 : Avancé
+---+---+---+---+
| P |   | T |   |
+---+---+---+---+
|   |   | T |   |
+---+---+---+---+
|   | F |   | F |
+---+---+---+---+
|   |   | P |   |
+---+---+---+---+