Niveau 30 : Intermédiaire
+---+---+---+---+
| C |   |   |   |
+---+---+---+---+
|   |   | T | C |
+---+---+---+---+
|   | F |   |   |
+---+---+---+---+
| T |   |   |   |
+---+---+---+---+