Niveau 17 : Intermédiaire
+---+---+---+---+
| F |   |   |   |
+---+---+---+---+
|   | T | P |   |
+---+---+---+---+
| Q |   |   |   |
+---+---+---+---+
|   | P |   |   |
+---+---+---+---+