Niveau 12 : Débutant
+---+---+---+---+
|   |   | F |   |
+---+---+---+---+
|   | Q |   |   |
+---+---+---+---+
| P |   |   | F |
+---+---+---+---+
|   |   |   |   |
+---+---+---+---+