Niveau 45 : Avancé
+---+---+---+---+
|   | C | T |   |
+---+---+---+---+
| C |   |   |   |
+---+---+---+---+
| F |   |   | F |
+---+---+---+---+
|   |   | P |   |
+---+---+---+---+