Niveau 14 : Débutant
+---+---+---+---+
|   | C |   |   |
+---+---+---+---+
|   |   | Q | T |
+---+---+---+---+
|   |   |   |   |
+---+---+---+---+
| F |   |   |   |
+---+---+---+---+