Niveau 8 : Débutant
+---+---+---+---+
| T |   | Q |   |
+---+---+---+---+
|   |   |   |   |
+---+---+---+---+
|   | C |   |   |
+---+---+---+---+
|   |   | P |   |
+---+---+---+---+