Niveau 44 : Avancé
+---+---+---+---+
| P |   |   |   |
+---+---+---+---+
| T |   | P |   |
+---+---+---+---+
| K | T |   |   |
+---+---+---+---+
| C | F |   | F |
+---+---+---+---+