Niveau 39 : Avancé
+---+---+---+---+
|   |   |   | F |
+---+---+---+---+
| C |   |   |   |
+---+---+---+---+
| F | Q |   |   |
+---+---+---+---+
|   | T | C |   |
+---+---+---+---+